1111111111111111111111111111111111111111111111111111111111111111111111111111111111111111111
10010000000C0000000000000000000000000000000000000000000000000000000000000000000000000000001
1000011111000000000000000000000000000000000000000000000000000000000000000000000000000000001
1P1011E000000000000000000000000000000000000000000000000000000000000000000000000000000000001
100010000C000000000000000000000000000000000000000000000000000000000000000000000000000000001
1000100000000000000000000000000000000000000000000000000000000000000000000000000000000000001
1000111100000000000000000000000000000000000000000000000000000000000000000000000000000000001
100C000C00C00000000000000000000000000000000000000000000000000000000000000000000000000000001
100C000C00C00000000000000000000000000000000000000000000000000000000000000000000000000000001
100C000C00C00000000000000000000000000000000000000000000000000000000000000000000000000000001
100C000C00C00000000000000000000000000000000000000000000000000000000000000000000000000000001
100C000C00C00000000000000000000000000000000000000000000000000000000000000000000000000000001
100C000C00C00000000000000000000000000000000000000000000000000000000000000000000000000000001
100C000C00C00000000000000000000000000000000000000000000000000000000000000000000000000000001
100C000C00C00000000000000000000000000000000000000000000000000000000000000000000000000000001
100C000C00C00000000000000000000000000000000000000000000000000000000000000000000000000000001
100C000C00C00000000000000000000000000000000000000000000000000000000000000000000000000000001
100C000C00C00000000000000000000000000000000000000000000000000000000000000000000000000000001
100C000C00C00000000000000000000000000000000000000000000000000000000000000000000000000000001
100C000C00C00000000000000000000000000000000000000000000000000000000000000000000000000000001
100C000C00C00000000000000000000000000000000000000000000000000000000000000000000000000000001
100C000C00C00000000000000000000000000000000000000000000000000000000000000000000000000000001
100C000C00C00000000000000000000000000000000000000000000000000000000000000000000000000000001
100C000C00C00000000000000000000000000000000000000000000000000000000000000000000000000000001
100C000C00C00000000000000000000000000000000000000000000000000000000000000000000000000000001
100C000C00C00000000000000000000000000000000000000000000000000000000000000000000000000000001
100C000C00C00000000000000000000000000000000000000000000000000000000000000000000000000000001
100C000C00C00000000000000000000000000000000000000000000000000000000000000000000000000000001
100C000C00C00000000000000000000000000000000000000000000000000000000000000000000000000000001
100C000C00C00000000000000000000000000000000000000000000000000000000000000000000000000000001
100C000C00C00000000000000000000000000000000000000000000000000000000000000000000000000000001
100C000C00C00000000000000000000000000000000000000000000000000000000000000000000000000000001
100C000C00C00000000000000000000000000000000000000000000000000000000000000000000000000000001
100C000C00C00000000000000000000000000000000000000000000000000000000000000000000000000000001
100C000C00C00000000000000000000000000000000000000000000000000000000000000000000000000000001
100C000C00C00000000000000000000000000000000000000000000000000000000000000000000000000000001
100C000C00C00000000000000000000000000000000000000000000000000000000000000000000000000000001
100C000C00C00000000000000000000000000000000000000000000000000000000000000000000000000000001
100C000C00C00000000000000000000000000000000000000000000000000000000000000000000000000000001
100C000C00C00000000000000000000000000000000000000000000000000000000000000000000000000000001
100C000C00C00000000000000000000000000000000000000000000000000000000000000000000000000000001
100C000C00C00000000000000000000000000000000000000000000000000000000000000000000000000000001
100C000C00C00000000000000000000000000000000000000000000000000000000000000000000000000000001
100C000C00C00000000000000000000000000000000000000000000000000000000000000000000000000000001
100C000C00C00000000000000000000000000000000000000000000000000000000000000000000000000000001
100C000C00C00000000000000000000000000000000000000000000000000000000000000000000000000000001
100C000C00C00000000000000000000000000000000000000000000000000000000000000000000000000000001
100C000C00C00000000000000000000000000000000000000000000000000000000000000000000000000000001
100C000C00C00000000000000000000000000000000000000000000000000000000000000000000000000000001
100C000C00C00000000000000000000000000000000000000000000000000000000000000000000000000000001
100C000C00C00000000000000000000000000000000000000000000000000000000000000000000000000000001
100C000C00C00000000000000000000000000000000000000000000000000000000000000000000000000000001
100C000C00C00000000000000000000000000000000000000000000000000000000000000000000000000000001
100C000C00C00000000000000000000000000000000000000000000000000000000000000000000000000000001
100C000C00C00000000000000000000000000000000000000000000000000000000000000000000000000000001
100C000C00C00000000000000000000000000000000000000000000000000000000000000000000000000000001
100C000C00C00000000000000000000000000000000000000000000000000000000000000000000000000000001
100C000C00C00000000000000000000000000000000000000000000000000000000000000000000000000000001
100C000C00C00000000000000000000000000000000000000000000000000000000000000000000000000000001
100C000C00C00000000000000000000000000000000000000000000000000000000000000000000000000000001
100C000C00C00000000000000000000000000000000000000000000000000000000000000000000000000000001
100C000C00C00000000000000000000000000000000000000000000000000000000000000000000000000000001
100C000C00C00000000000000000000000000000000000000000000000000000000000000000000000000000001
100C000C00C00000000000000000000000000000000000000000000000000000000000000000000000000000001
100C000C00C00000000000000000000000000000000000000000000000000000000000000000000000000000001
100C000C00C00000000000000000000000000000000000000000000000000000000000000000000000000000001
100C000C00C00000000000000000000000000000000000000000000000000000000000000000000000000000001
100C000C00C00000000000000000000000000000000000000000000000000000000000000000000000000000001
100C000C00C00000000000000000000000000000000000000000000000000000000000000000000000000000001
100C000C00C00000000000000000000000000000000000000000000000000000000000000000000000000000001
100C000C00C00000000000000000000000000000000000000000000000000000000000000000000000000000001
100C000C00C00000000000000000000000000000000000000000000000000000000000000000000000000000001
100C000C00C00000000000000000000000000000000000000000000000000000000000000000000000000000001
100C000C00C00000000000000000000000000000000000000000000000000000000000000000000000000000001
100C000C00C00000000000000000000000000000000000000000000000000000000000000000000000000000001
100C000C00C00000000000000000000000000000000000000000000000000000000000000000000000000000001
100C000C00C00000000000000000000000000000000000000000000000000000000000000000000000000000001
100C000C00C00000000000000000000000000000000000000000000000000000000000000000000000000000001
100C000C00C00000000000000000000000000000000000000000000000000000000000000000000000000000001
100C000C00C00000000000000000000000000000000000000000000000000000000000000000000000000000001
100C000C00C00000000000000000000000000000000000000000000000000000000000000000000000000000001
100C000C00C00000000000000000000000000000000000000000000000000000000000000000000000000000001
100C000C00C00000000000000000000000000000000000000000000000000000000000000000000000000000001
100C000C00C00000000000000000000000000000000000000000000000000000000000000000000000000000001
100C000C00C00000000000000000000000000000000000000000000000000000000000000000000000000000001
100C000C00C00000000000000000000000000000000000000000000000000000000000000000000000000000001
100C000C00C00000000000000000000000000000000000000000000000000000000000000000000000000000001
100C000C00C00000000000000000000000000000000000000000000000000000000000000000000000000000001
100C000C00C00000000000000000000000000000000000000000000000000000000000000000000000000000001
100C000C00C00000000000000000000000000000000000000000000000000000000000000000000000000000001
100C000C00C00000000000000000000000000000000000000000000000000000000000000000000000000000001
100C000C00C00000000000000000000000000000000000000000000000000000000000000000000000000000001
100C000C00C00000000000000000000000000000000000000000000000000000000000000000000000000000001
100C000C00C00000000000000000000000000000000000000000000000000000000000000000000000000000001
100C000C00C00000000000000000000000000000000000000000000000000000000000000000000000000000001
100C000C00C00000000000000000000000000000000000000000000000000000000000000000000000000000001
100C000C00C00000000000000000000000000000000000000000000000000000000000000000000000000000001
1111111111111111111111111111111111111111111111111111111111111111111111111111111111111111111