1111111111111
1000010000001
10000000P0001
1E00010C00001
1111111111111