1111111111111
1P110000000C1
1010010E00001
1000010000001
1111111111111