1111111111111
1P0100C000E01
1010011111111
1000010000001
1111111111111