1111111111111
1P0100E000001
1010010000001
100C010000001
1111111111111